12 12 12 12 12 12 12 12 12 12 12 12 12 12 12 12 12 12 12
12 18 -1 -1 -1 -1 -1 -1 -1 12 -1 -1 -1 -1 -1 -1 -1 18 12
12 -1 14 14 -1 14 14 14 -1 12 -1 14 14 14 -1 14 14 -1 12
12 -1 -1 -1 -1 -1 -1 -1 -1 -1 -1 -1 -1 -1 -1 -1 -1 -1 12
12 -1 14 14 -1 14 -1 12 12 12 12 12 -1 14 -1 14 14 -1 12
12 -1 -1 -1 -1 14 -1 -1 -1 12 -1 -1 -1 14 -1 -1 -1 -1 12
12 12 12 12 -1 14 14 14 -1 12 -1 14 14 14 -1 12 12 12 12
-1 -1 -1 12 -1 14 -1 -1 -1 18 -1 -1 -1 14 -1 12 -1 -1 -1
12 12 12 12 -1 14 -1 12 12 -1 12 12 -1 14 -1 12 12 12 12
-1 -1 -1 -1 -1 -1 -1 12 17 17 17 12 -1 -1 -1 -1 -1 -1 12
12 12 12 12 -1 14 -1 12 12 -1 12 12 -1 14 -1 12 12 12 12
-1 -1 -1 12 -1 14 -1 -1 -1 -1 -1 -1 -1 14 -1 12 -1 -1 -1
12 12 12 12 -1 14 14 14 -1 12 -1 14 14 14 -1 12 12 12 12
12 -1 -1 -1 -1 14 -1 -1 -1 12 -1 -1 -1 14 -1 -1 -1 -1 12
12 -1 14 14 -1 14 -1 12 12 12 12 12 -1 14 -1 14 14 -1 12
12 -1 -1 -1 -1 -1 -1 -1 -1 16 -1 -1 -1 -1 -1 -1 -1 -1 12
12 -1 14 14 -1 14 14 14 -1 12 -1 14 14 14 -1 14 14 -1 12
12 18 -1 -1 -1 -1 -1 -1 -1 12 -1 -1 -1 -1 -1 -1 -1 18 12
12 12 12 12 12 12 12 12 12 12 12 12 12 12 12 12 12 12 12