-1 -1 -1 -1 -1 -1  6 -1 -1 13 -1  5 -1 -1 -1  2 -1 15 15 15 15 -1 18 11 -1 -1 -1 -1 -1 -1 -1 18
 0 -1 -1 -1 -1 -1 -1 -1 -1 13 -1 -1 -1 -1 14 -1 -1 15 15 15 -1 -1 -1  0 -1 -1 -1 -1 -1 -1 -1 -1
-1 -1  0 -1 -1 12 12 12 -1 13 -1 -1  1 -1 14 -1 -1 -1 15 18 05 -1 -1 -1 -1 -1 18 07 -1 -1 -1 -1
-1 -1 -1 -1 -1 12 11 11 11 13 -1 -1 -1 -1 14 -1 -1 15 15 -1 -1 -1 18 03 -1 -1 -1 -1 -1 -1 -1 -1
17 -1  7 -1 -1 12 16 -1 -1 13  2 -1 -1 -1 14 -1 -1  4 -1 -1 -1 -1 -1 -1 -1 12 -1  5 -1 -1 -1 -1
-1 -1 -1 -1 -1 12 -1 -1 -1 13 -1 -1  1 -1 14 -1 -1 -1  1 -1 -1 -1 -1 -1 -1 -1 -1 -1 -1 18 03 -1
-1  8  1 -1 -1 12 12 12 -1 13 13 -1 -1 -1 14 -1 -1  4 -1 -1 -1 18 04 -1 18 04 -1  6 -1 -1 -1 -1
-1 -1 -1 -1  9 -1 -1 -1 -1 -1 11 -1 -1 -1 14 17 -1 -1 -1 -1 -1 -1 -1 -1 10 -1 -1 -1 -1 -1 -1 -1